Time,Monday,Tuesday,Wednesday,Thursday,Friday
08:00,5,5,5,5,5
08:30,5,5,5,5,5
09:00,5,5,5,5,5
09:30,5,5,5,5,5
10:00,5,5,5,5,5
10:30,5,5,5,5,5
11:00,5,5,5,5,5
11:30,5,5,5,5,5
12:00,5,5,5,5,5
12:30,3,3,3,3,3
13:00,3,3,3,3,3
13:30,3,3,3,3,3
14:00,3,3,3,3,3
14:30,3,3,3,3,3
15:00,3,3,3,3,3
15:30,3,3,3,3,3
16:00,3,3,3,3,3
16:30,3,3,3,3,3
17:00,3,3,3,3,3
17:30,3,3,3,3,3